##########
#........#
#........#
#........#
....##...#
....##...#
#........#
#........#
#........#
##########