##########
#........#
#........#
#........#
#...##....
#...##....
#........#
#........#
#........#
##########